NO ./pictures/grenouille.xpm

SO ./pictures/Damien-de-bourg-palette.xpm

WE ./pictures/Damien-des-profondeurs.xpm

EA ./pictures/Damien-Potter.xpm

F 255,0,255
C 255,102,102


               1111111
               1000001
               1000001
               1000001
               1000001
               1000001
               1000001
               1000001
               1000001
               1000001
               1000001
               1000001
               1000001
               1000001
            1111000001111
111111111111111100000111111111111111
100000000000000000000000000000000001
100000000000000000000000000000000001
100000000000000000N00000000000000001
100000000000000000000000000000000001
100000000000000000000000000000000001
111111111111111100000111111111111111
               1000001
               1000001
               1000001
               1000001
               1000001
               1000001
               1000001
               1000001
               1000001
               1000001
               1000001
               1000001
               1000001
               1000001
               1111111