
NO ./path_to_the_north_texture

SO ./path_to_the_south_texture

WE ./path_to_the_west_texture

EA ./path_to_the_east_texture

F 255,0,0
C 143,0,255

111111
111001
100111
10N001
100001
111111
