1111111111111111111111111111111
1000000000110000000000001000001
1011000001110000000000001111111
100100000000000000000000111111111
111111111011000001110000000000001
100000000011000001110111111111111
11110111111111011100000000001
11110111111111011101010000001
1100000011010101110000010001
10000000000000001100000010001
100000N00000000011010100100001
11000001110101011111011110111
11110111 1110101 101111010001
11111111 1111111 111111111111