
NO ./path_to_the_north_texture

SO ./path_to_the_south_texture

WE ./path_to_the_west_texture

EA ./path_to_the_east_texture

F 225,100,0
C 225,30,0

11111
10001
11111
11111
100011111111
10S011000001
100011111111
100011000001
101011111111
100010000001
111111111111

