
NO ./pictures/Captaine-ferjul.xpm

SO ./pictures/Damien-de-bourg-palette.xpm

WE ./pictures/Damien-Potter.xpm

EA ./pictures/Damien-des-profondeurs.xpm

C 255,102,155
F 1,,,,,1,1

1111111111111111111111111
1000000000110000000000001
1011000001110000000000001
100100000000000000000000111111111
1111111110110000011100100000000001
100000000011000001110111110111111
11110111111111011100000010001
11110111111111011101010010001
11000000110101011100000010001
10000000000000001100000010001
10000000000000001101010010N01
110000011101010111110111100111
11110111 1110101 101111010001
11111111 1111111 111111111111