
NO ./path_to_the_north_texture

SO ./path_to_the_south_texture

WE ./path_to_the_west_texture

EA ./path_to_the_east_texture

F 225,100,0
C 225,30,0

11111
100N11111111111111
1111111111111111
11100000011111
1111111111