
NO ./pictures/Captaine-ferjul.xpm

SO ./pictures/Damien-de-bourg-palette.xpm

WE ./pictures/Damien-Potter.xpm

EA ./pictures/Damien-des-profondeurs.xpm

F 125,0,255
C 255,102,155

11111
10001
10E001
10001
10001
10101
10101
10101
11111
11111
11111
11111