
NO ./path_to_the_north_texture

SO ./path_to_the_south_texture

WE ./path_to_the_west_texture

EA ./path_to_the_east_texture

F 255,25,256            
C 225,30,100

11111
11101
10011
10N01
10001
11111
