
NO ./path_to_the_north_texture

SO ./path_to_the_south_texture

WE ./path_to_the_west_texture

EA ./path_to_the_east_texture

F 225,100,0
C 225,30,0

1111111111111111111111111
1000000000110000000000001
101100000111000000000N001
10010000000000000000000111111111
1111111111111111111111111


