1111111111111111111111111
1000000000110000000000001
1011000001110000000000001
100100000000000000000000111111111
11111111101100001110000000000001
100000000011000001110111111111111
11110111111111011100000010001
11110111111111011101010010001
110000001101N1011100000010001
1000000000000001100000010011
10000000000000001101010010001
110000011101010111110111100111
11110111 1110101 101111010001
11111111111111111111111111111